11111111111
10000010001
1N0001E0101
100P00C00N1
11111111111