1111111111
10E0000C01
1P00C01001
10C0C00C01
1111111111