11111111111
100CC010001
1C0001E1C01
100P00C0001
11111111111